DDHE	SWHE
DDIZ	BARL
SOYA	BARL
WBAR	WWHE
OATS	SWHE
WRYE	WWHE
OCER	BARL
WSWH	WWHE
SBAR	BARL
SSWH	WWHE
PARI	BARL
PULS	SWHE
RYEM	WWHE
TEXT	BARL
TOBA	SWHE
OIND	WWHE
OCRO	WWHE
ROOF	SUGB
OFAR	BARL
NONF	SETA
FALL	SETA




